OOOOOOOOOOOOOOS
OXEEGEEEEEGEEXO
OOOEEEEGEEEEOOO
OGHXEEEEEEEXOGO
OEOOOEEEEEONOEO
OEEGOXEEEXOGEEO
OEEEOOOEOOOEEEO
OEEEEXOXOXEEEEO
OEEEEEOXOEEEEEO
OOOOOOOOOPOOOOO