OOOOOGXGXGOHOOS
EEXXOXEXEXOXGGX
EXXXOXEXEXOXEEX
XGGXNXEXEXOEEEE
EEEEOXEXEXOEEEE
EEEEOOOOOOOXEEX
XEEXXEXOXEXXEEX
XEEXXEXOXEXXXXX
EXXXXEXOXEXXXXE
EEXXXEXPXEXXXEE