OXXXGXXXXXOOOOS
OXXEEXXEXXOXGXX
HGXEEXXEXXNXXXX
OXXEEGXEGXOXEEE
OXXEEXXEXXOXEEE
OOXEEXXEXXOXEEE
XOXXXXGXGXOXXXX
XOOOOXXXXXOXXXX
EXXXOXXXXXOXXXE
EEXXOOOPOOOXXEE