OONOOOXXGXGXXOS
XEEXXOXXXXXXXOX
XEEXXOXEEEEEXOX
GEEGXOXEEEEEXHX
EEEEXOXXXXXXXOX
EEEEXOXGXXOOOOX
XEEXXOXEEXOXXXX
XGGXXOEEEEOXEEX
EXXXXOXEEXOXEEX
EEXXXOOPOOOXXXX