OOOOOOOOOOOOOOS
OEGEEOXOXOEEGEO
OEEEXOGOGOXEEEO
OEEEOOXOXOOEEEO
OEEXHXEOEXOXEEO
OEEOOXEOEXOOEEO
OEXOXEEOEEXOXEO
OEOOGEEOEEGOOEO
OEOEEEEOEEEEOEO
ONOOOOOOPOOOOOO