OOOOOOOOOOOOOOS
OGEEEEGOEEEEEEO
OEEEEEEOXEEGEXO
NXEEEEXOEEGEEEO
OEEEEEEOXEEEEXH
OXEEEEXOGEEEEEO
OEEGEEEOXEEEEXO
OXEEGEXOEEEEEEO
OEEEEEEOEEEEEEO
OOOOOOOOPOOOOOO