OOEEEEEOEEEEEOS
XOEGEGEOEGEGEOX
GOEEEEEOEEEEEOG
EOOEEEEHEEEEOOE
EEOXEEEOEEEXOEE
EENOOEEOEEOOOEE
EEEEOXEOEXOEEEE
EEEEOOXOXOOEEEE
EEEEEOXOXOEEEEE
EEEEEOOPOOEEEEE