HOGEEEEGEEEEGOS
EOXXEEEEEEEXXOE
EOOOXEEEEEXNOOE
EXXOXXEEEXXOXXE
XXXOOOXEXOOOXXX
XXGXXOXGXOXXGXX
XXEXXOEEEOXXEXX
XEEEXOOOOOXEEEX
EEEEEXEOEXEEEEE
EEEEEXEPEXEEEEE